1111111111111111111111111111111111111111
1000000000000000000000100000000000000001
1000000000000000000000100000000000000031
1000000000000000000000100000001000000111
1000000000000000000000111100000000000121
1000000000000000000000000000000000001121
1000000000000000000000000000111111111121
1000000000000000000000000001122222222221
1000000000000000000001122211111111111111
1000000000001000100000002100000000000001
1000000000011222222222222100000000000001
1000111100011111111111111100000000000001
1000000000000000000000000000000000000001
1100000000000000100000000000000000000031
1110000000000000100000000000000000000011
1222211110000001100000000000000000010001
1111110000001000100000000000000000000001
1000000000001000100000000000000000000011
1000000011111100000000000000000000000001
1000000010000000000010000100001000010001
1221122212222211112222222222222222222221
1111111111111111111111111111111111111111
1111111111111111111111111111111111111111