1111111111111111111111111111111111111111
1000000000000000000000000000000000000001
1000000000000000000000000000000000000001
1000000000000000000000000000000000000001
1000000000000000000000000000000000000001
1000000000000000000000000000000000000001
1000000000000000000000000000000000000001
1000000000000000000000000000000000000001
1000000000000000000000000000000000000001
1000030000000000000000000000000000000001
1000011111111122222112221110001110000001
1000010000000111111111111111111111000001
1000010003000000000000000000000001000001
1000010011000000000000000000000001100001
1000010000000000000000000000000000000001
1000011000000000000000010000001000000011
1000011111111111111100000000000000000001
1000000000000000000000000000000000111001
1000000000000000000000000000011100000001
1000000000000000000000000000111122222221
1000000000000000000000000001111122222221
1111111111111111111111111111111111111111
1111111111111111111111111111111111111111